P1 does not delay a draw, map with obstacles
x2x..x2x
222222..
x22x222x
11x22x22
11x11x22
x111x11x
1111111.
x1x11x1x
