Columns
x.x..x1x
.1......
x..x.1.x
..x..x..
..x..x..
x.2.x..x
......2.
x2x..x.x
