Corridor
11......
1.......
..xx....
..x.....
.....x..
....xx..
.......2
......22
