Island
1......2
........
........
...xx...
...xx...
........
........
2......1
