Rocks
.x.x1x..
..x.x...
...x.x..
..x.....
.....x..
..x.x...
...x.x..
..x2x.x.
