Trees
1.x2...1
..x..x..
x......x
2..x....
....x..1
x......x
..x..x..
2...1x.2
