Walls
1......2
.x.xx.x.
..x..x..
........
........
..x..x..
.x.xx.x.
2......1
